NO NO NO NO BL NO NO FI NO NO BL NO NO NO NO
NO NO NO NO NO HO VE HO VE HO NO NO NO NO NO
VE NO NO NO NO NO BO NO BO NO NO NO NO NO VE
VE NO BL NO NO BL NO VE NO BL NO NO BL NO VE
NO NO NO NO NO NO NO NO NO NO NO NO NO NO NO
NO BL NO BL NO HO NO BO NO HO NO BL NO BL NO
NO NO NO NO NO NO NO NO NO NO NO NO NO NO NO
VE NO BL NO NO BL NO VE NO BL NO NO BL NO VE
VE NO NO NO NO NO NO NO NO NO NO NO NO NO VE
NO NO NO NO HO HO NO PL NO HO HO NO NO NO NO