NO NO NO NO BL NO NO FI NO BL BL NO NO NO NO
NO NO NO NO BL BL NO NO NO NO BL NO NO NO NO
NO NO HO HO HO HO HO VE HO HO HO NO NO BL VE
NO NO BL NO NO NO NO BO VE NO NO BL BL BL VE
VE NO HO NO NO NO NO NO BO NO NO NO NO NO VE
VE BO NO BL BL NO NO NO NO NO NO BL NO NO NO
VE BL BL NO NO BL BL BL BL NO NO NO NO BL NO
VE NO NO VE NO NO BL BL BL NO NO BL NO HO NO
VE NO BL NO BO VE NO NO BL NO NO HO VE BL NO
NO NO BL NO BL NO NO PL HO NO NO BL NO HO NO